# # # # # # #
# S . . . . #
# # # . # . #
# . . . # . #
# . # # # . #
# . . . . G #
# # # # # # #